...............
.....D...D.....
......D.D......
......D.D......
.....AAAAA.....
....AAAAAAA....
...AAACACAAA...
..AAAACACAAAA..
.AAAAAAAAAAAAA.
.AAAAAAAAAAAAA.
.AA..AAAAA..AA.
.AA..B...B..AA.
.E...B...B...E.
.E....B.B....E.
..E...B.B...E..